########################################
#                  #                   #
#    ######        #     ###   ###     #
#    #             #     #       #     #
#    #                   #       #     #
#    ######        #     #########     #
#       #          #                   #
#       ############                   #
#                                      #
#          #   #          #   #        #
#    #######   ###### #####   #####    #
#          #   #          #   #        #
#    #######   #          #   #####    #
#              #          #            #
########################################