########################################
#                  #                   #
#    ######        #     ###   ###  *  #
#    #         *   #     #   .   #     #
#    #  .                #       #     #
#    ######        #     #########     #
#                  #                   #
#       ############        *          #
#                 .                    #
# *                                    #
#    #######   ###### #####   #####    #
#      .   #   #          #   #     *  #
#    #######   #    .  *  #   #####    #
#              #          #            #
########################################