GetAllCoins
####################
# R  .  .   .  .   #
# ########  ####   #
#  .  #   .  .     #
#  .  ####  .   *  #
     .  .  H  .     
######   ########  #
#  .  W  .  .   .  #
# R  .  .  .  .    #
####################
