# ##################
#        #     C   #
# ###### #   ###   #
#  R   # #   # .   #
       #     # G    
#  *   #######     #
#      D  .    *   #
#  #####  *  ###   #
#  #      .  #     #
# ############### ##