##########################################
#   .    #           #       * #   .   # #
# ###### # ######### # ######### # ##### #
# #      * # .       # #       # #     # #
# # ###### ######### # # ##### # # ### # #
# # #      * . # # # #   # #   #   # #   #
# # # ############ # # # # # # ##### ### #
# . # #          # # . # # * #     # # . #
####### ######## # ##### # # ##### # # # #
#       * # #       # #     # * # # #    #
# ############ # ######### ##### ##### # #
# .    #   .   #           # .   #     # #
###### # ################# # ##### ##### #
#      # * #   * # .   #   .   #         #
##########################################