####################
#        #         #
# ###### #   ###   #
#      # #   # .   #
#      #     #     #
#  *   #######     #
#         .    *   #
#  #####  *  ###   #
#  #      .  #     #
####################