# ##################
#        #         #
# ###### #   ###   #
#      # #   # .   #
       #     #      
#  *   #######     #
#      D  .    *   #
#  #####  *  ###   #
#  #      .  #     #
# ############### ##