KillAllEnemies
##########################
#  R  W  .   .  .  .  R  #
# ######   ######  ####  #
#  .  .   D  W  .  .  C  #
#  .  ###  W  *  .  ###  #
      .  .  H  .  W       
# #####  ######  #####  ##
#  W  .  G  .  .  .   .  #
#  .  ##  * ####  ##  .  #
   .  . R  .  .  .  .  W  
# #####  ######  #####  ##
#  .  .  W  .  .  .  .   #
##########################
