PickCrownItem
##############################
# R  .  *  .  G  .  *  .  R  #
# ###### ## ##### ## ######  #
#  .  .  *  .  .  C  .  .    #
# ##  ###  ##  ###  ##  ###  #
    .  D  .  H  .  D  .       
# ##  ###  ##  ###  ##  ###  #
#  .  . *  .  K  . * .  .    #
# ###### ## ##### ## ######  #
   .  . G  . W  G .  .  .     
# ######  ####  ####  ###### #
#  .  R  . * . C . *  .  .   #
# ##########  ##########  ## #
#  .  W  .  H  .  .  .  .    #
##############################
