# ##################
#        #         #
# ###### #   ###   #
#  R   # #   # .   #
       #     # G    
#  *   #######     #
#      D  .    *   #
#  #####  *  ###   #
#  #      .  #     #
# ############### ##